2222222222
2011121112
2221121132
2221111222
2321111112
2111121112
2112224142
2222222222
