2222222222
2221121112
2411121112
2221111132
2131111112
2221121112
2411121202
2222222222
